N ? ? ? ? ? ? ? ? ? ? ? N N N
N ? ? ? ? ? ? N ? ? ? ? N N N
N ? ? ? ? ? ? Y N ? ? ? N N N
N ? ? ? ? ? ? P ? ? ? ? N N N
N ? ? ? ? ? ? ? ? ? ? ? N N N
N ? ? ? ? ? ? ? ? ? ? ? N N N
N ? ? ? ? ? ? ? ? ? ? ? N N N
N ? ? ? ? ? ? ? ? ? ? ? N N N