? ? ? ? ? ? ? ? ? ? ? ? ? N N N N
? ? ? ? ? ? ? ? N N ? ? ? N N N N
? ? ? ? ? ? ? P Y Y ? ? ? N N N N
? ? ? ? ? ? ? Y Y ? ? ? ? N N N N
? ? ? ? ? ? ? Y ? ? ? ? ? N N N N
? ? ? ? ? ? ? Y ? ? ? ? ? N N N N
? ? ? ? ? ? Y Y ? ? ? ? ? N N N N
? ? ? ? ? ? ? ? ? ? ? ? ? N N N ?
? ? ? ? ? ? ? ? ? ? ? ? ? N N ? ?
? ? ? ? ? ? ? ? ? ? ? ? ? N N ? ?
? ? ? ? ? ? ? ? ? ? ? ? ? N N ? ?